xxxxxxxxxxxxxxxxxxxxxxxxxxxxxxxxxxxxxxxx
x                                      x
x                                      x
x                                      x
x                                      x
x                                      x
x                                      x
x                                      x
x                                      x
x                                      x
x                 xx                   x
x                                      x
x                                      x
x            x               x         x
x                                      x
x                                      x
x                                      x
x                                      x
x                       x              x
x                                      x
x                                      x
x                                      x
x                                      x
x                                      x
x        xxxxx                         x
x                                      x
x                                      x
x                                      x
x                                      x
xxxxxxxxxxxxxxxxxxxxxxxxxxxxxxxxxxxxxxxx